- - wiyaw	 NDI-1	 body; his/her body	 {w-} + -iyaw-
- kikâwînaw	 NDA-2	 Our Mother, The Earth	 {ki-} + -kâwiy- + {-inaw}
- kôhtâwînaw	 NDA-2	 Our Father; Our Creator ;; [Christian:] Heavenly Father, Our Father; Our Lord	 {k-} + -ohtâwiy- + {-inaw}
- macâs	 NDI-1	 small stomach, small belly	 {m-} + -acâs-
- mahkwan	 NDI-1	 heel	 {m-} + -ahkwan-
- mahkwanikan	 NDI-1	 heelbone	 {m-} + -ahkwanikan-
- mahkwanêyâpiy	 NDI-2	 achilles tendon, tendon at back of heel	 {m-} + -ahkwanêyâpiy-
- maniway	 NDI-2	 cheek	 {m-} + -aniway-
- masakay	 NDA-2	 skin	 {m-} + -asakay-
- maskasiy	 NDA-2	 fingernail; claw	 {m-} + -askasiy-
- maskatay	 NDI-2	 stomach-covering; abdominal-wall, belly (of an animal) [i.e. tough meat layered with fat]	 {m-} + -askatay-
- matay	 NDI-2	 belly, abdomen; stomach	 {m-} + -atay-
- mayakask	 NDI-3	 palate	 {m-} + -ayakaskw-
- micicâskay	 NDI-2	 crotch	 {mi-} + -cicâskay-
- micicâskâs	 NDI-1	 crotch, pubic region	 {mi-} + -cicâskâs-
- micihciy	 NDI-2	 hand; paw (e.g. bear)	 {mi-} + -cihciy-
- micihcîs	 NDI-1	 finger; little hand	 {mi-} + -cihcîs-
- micisk	 NDI-1	 anus	 {mi-} + -cisk-
- miciskakisiy	 NDI-2	 rectum (lower end)	 {mi-} + -ciskakisiy-
- miciskêyâpiy	 NDI-2	 rectum (full length)	 {mi-} + -ciskêyâpiy-
- micohcôsimis	 NDA-1	 nipple (of a breast); small breast	 {mi-} + -cohcôsimis-
- micâsis	 NDA-1	 small pair of pants, shorts; underpants; loin-cloth; leggings	 {mi-} + -câsis-
- micêhis	 NDI-1	 small heart, little heart	 {mi-} + -cêhis-
- micêstatay	 NDI-2	 muscle	 {mi-} + -cêstatay-
- micîhcîkom	 NDA-1	 wart	 {mi-} + -cîhcîkom-
- micônis	 NDI-1	 small mouth; [plural:] lips	 {mi-} + -cônis-
- micôskwanis	 NDI-1	 little elbow	 {mi-} + -côskwanis-
- mihcawakâs	 NDI-1	 little ear	 {mi-} + -htawakâs-
- mihcikwan	 NDI-1	 knee	 {mi-} + -hcikwan-
- mihcikwanikan	 NDI-1	 kneebone	 {mi-} + -hcikwanikan-
- mihkwâkan	 NDI-1	 face	 {mi-} + -hkwâkan-
- mihkwâkanis	 NDI-1	 face	 {mi-} + -hkwâkanis-
- mihtawakay	 NDI-2	 ear	 {mi-} + -htawakay- OBS
- mikitik	 NDI-3	 kneecap; knee	 {mi-} + -kitikw-
- mikohcaskwayêyâpîsa	 NDI-1	 bronchial tubes	 {mi-} + -kohcaskwayêyâpîs-
- mikohtaskway	 NDI-2	 throat	 {mi-} + -kohtaskway-
- mikohtaskwayêyâpiy	 NDI-2	 windpipe	 {mi-} + -kohtaskwayêyâpiy-
- mikohtâkan	 NDI-1	 throat	 {mi-} + -kohtâkan-
- mikot	 NDI-1	 nose; beak	 {mi-} + -kot-
- mikwayaw	 NDI-2	 neck	 {mi-} + -kwayaw-
- mikwayawikan	 NDI-1	 neck-bone	 {mi-} + -kwayawikan-
- mikwâskonêw	 NDI-2	 chin	 {mi-} + -kwâskonêw-
- mikwâskonêwikan	 NDI-1	 chin	 {mi-} + -kwâskonêwikan-
- mipwâm	 NDI-1	 thigh	 {mi-} + -pwâm-
- mipwâmikan	 NDI-1	 femur; thighbone	 {mi-} + -pwâmikan-
- miscikwânis	 NDI-1	 little head, baby's head	 {mi-} + -scikwânis-
- misicis	 NDI-1	 small foot, little foot	 {mi-} + -sicis-
- misit	 NDI-1	 foot	 {mi-} + -sit-
- miskan	 NDI-1	 bone	 {mi-} + -skan-
- miskanis	 NDI-1	 small bone	 {mi-} + -skanis-
- miskiwan	 NDI-1	 nose, snout	 {mi-} + -skiwan-
- miskiwanikan	 NDI-1	 nasal bone	 {mi-} + -skiwanikan-
- miskocâkâs	 NDI-1	 small coat, jacket; dress; short skirt	 {mi-} + -skocâkâs-
- miskon	 NDI-1	 liver	 {mi-} + -skon-
- miskotâkay	 NDI-2	 coat, jacket; dress; skirt	 {mi-} + -skotâkay-
- miskâhtik	 NDI-3	 forehead	 {mi-} + -skâhtikw-
- miskâhtikwanikan	 NDI-1	 frontal bone of skull	 {mi-} + -skâhtikwanikan-
- miskât	 NDI-1	 leg	 {mi-} + -skât-
- miskâtikan	 NDI-1	 legbone	 {mi-} + -skâtikan-
- miskîsik	 NDI-3	 eye	 {mi-} + -skîsikw-
- miskîsikohkâna	 NDI-1	 eye glasses	 {mi-} + -skîsikohkân-
- miskîsikos	 NDI-1	 small eye, little eye	 {mi-} + -skîsikos-
- miskîsikwâpitân	 NDI-1	 eye-tooth	 {mi-} + -skîsikwâpitân-
- mispayowak	 NDA-2	 ovaries	 {mi-} + -spayow-
- mispiconis	 NDI-1	 little arm; fore-arm of a small animal	 {mi-} + -spiconis-
- mispikay	 NDI-2	 rib; side; [plural:] ribs, sides of the torso	 {mi-} + -spikay-
- mispikêkan	 NDI-1	 rib, rib-bone	 {mi-} + -spikêkan-
- mispiskwan	 NDI-1	 back	 {mi-} + -spiskwan-
- mispiton	 NDI-1	 arm	 {mi-} + -spiton-
- mistikwân	 NDI-1	 head; mind	 {mi-} + -stikwân-
- mistikwânaskatihkway	 NDI-2	 top of skull, parietal bone	 {mi-} + -stikwânaskatihkway-
- mistikwânikan	 NDI-1	 skull	 {mi-} + -stikwânikan-
- misôkan	 NDI-1	 tail-bone; rear-end, buttocks	 {mi-} + -sôkan-
- mitahtahkwan	 NDI-1	 wing	 {mi-} + -tahtahkwan-
- mitakay	 NDI-2	 penis	 {mi-} + -takay-
- mitakikom	 NDA-1	 mucus, snot, rheum	 {mi-} -takikom-
- mitakisiya	 NDI-2	 intestines	 {mi-} + -takisiy-
- mitapiskohkêw	 NDI-1	 back of skull, occipital bone	 {mi-} + -tapiskohkêw-
- mitasiskitân	 NDI-1	 calf of the leg; ligament	 {mi-} + -(t)asiskitân-
- mitihtihkos	 NDA-1	 kidney	 {mi-} + -tihtihkos-
- mitihtihkosiw	 NDA-2	 kidney	 {mi-} + -tihtihkosiw-
- mitihtihkosiy	 NDA-2	 kidney	 {mi-} + -tihtihkosiy-
- mitihtikon	 NDI-3	 armpit	 {mi-} + -tihtikon-
- mitihtiman	 NDI-1	 shoulder	 {mi-} + -tihtiman-
- mitihtimanikan	 NDI-1	 shoulder-bone	 {mi-} + -tihtimanikan-
- mitisiy	 NDI-2	 navel, belly-button	 {mi-} + -tisiy-
- mitisiyêyâpiy	 NDI-2	 umbilical cord	 {mi-} + -tisiyêyâpiy-
- mitiskwêspiy	 NDI-2	 bottom rib	 {mi-} + -(t)iskwêspiy-
- mitisowayak	 NDA-2	 testicles	 {mi-} + -tisoway-
- mitiy	 NDI-2	 bum; buttocks	 {mi-} + -tiy-
- mitohtôsim	 NDA-1	 breast, nipple	 {mi-} + -tohtôsim-
- mitokan	 NDI-1	 hip	 {mi-} + -tokan-
- mitâkay	 NDA-2	 vagina, vulva	 {mi-} + -tâkay-
- mitâpiskan	 NDI-1	 jaw; chin	 {mi-} + -tâpiskan-
- mitâs	 NDA-1	 pair of pants	 {mi-} + -tâs-
- mitâs	 NDI-1	 legging, gaiter	 {mi-} + -tâs-
- mitâsiyân	 NDA-1	 loin-cloth, breech clout; diaper	 {mi-} + -(t)âsiyân-
- mitêh	 NDI-1	 heart	 {mi-} + -têh-
- mitêskan	 NDA-1	 horn; antler	 {mi-} + -(t)êskan-
- mitêyaniy	 NDI-2	 tongue	 {mi-} + -têyaniy-
- mitêyaniyâpiy	 NDI-2	 tongue string	 {mi-} + -têyaniyâpiy-
- mitêyikom	 NDI-1	 nostril	 {mi-} + -têyikom-
- mitîhikan	 NDI-1	 shoulder-blade	 {mi-} + -tîhikan-
- mitîhiy	 NDA-2	 shoulder-blade	 {mi-} + -tîhiy-
- mitîhkôkan	 NDI-1	 armpit	 {mi-} + -tîhkôkan-
- mitôn	 NDI-1	 mouth	 {mi-} + -tôn-
- mitôskwan	 NDI-1	 elbow	 {mi-} + -tôskwan-
- miyaw	 NDI-1	 body; corpse, dead body	 {m-} + -iyaw-
- mâskikan	 NDI-1	 chest, breast	 {m-} + -âskikan-
- mâskikanis	 NDI-1	 small chest, small breast	 {m-} + -âskikanis-
- mâwikan	 NDI-1	 backbone, spine; back	 {m-} + -âwikan-
- mêscakâsa	 NDI-1	 hair; short hair	 {m-} + -êscakâs-
- mêstakaya	 NDI-2	 hair	 {m-} + -êstakay-
- mîpicikan	 NDI-1	 gums	 {m-} + îpicikan-
- mîpit	 NDI-1	 tooth	 {m-} + -îpit-
- mîpitihkâna	 NDI-1	 false teeth, dentures	 {m-} + -îpitihkân-
- mîtihp	 NDI-1	 brain	 {m-} + -îtihp-
- nacâs	 NDI-2	 my little stomach, my small belly	 {n-} + -acâs-
- nahkwan	 NDI-1	 my heel	 {n-} + -ahkwan-
- nahkwanikan	 NDI-1	 my heelbone	 {n-} + -ahkwanikan-
- nahkwanêyâpiy	 NDI-2	 my achilles tendon, the tendon at back of my heel	 {n-} + -ahkwanêyâpiy-
- naniway	 NDI-2	 my cheek	 {n-} + -aniway-
- nasakay	 NDA-2	 my skin	 {n-} + -asakay-
- naskasiy	 NDA-2	 my fingernail; my claw	 {n-} + -askasiy-
- naskatay	 NDI-2	 my stomach-covering; my abdominal-wall	 {n-} + -askatay-
- natay	 NDI-2	 my belly, my abdomen; my stomach	 {n-} + -atay-
- nayakask	 NDI-3	 my palate	 {n-} + -ayakaskw-
- nicawâsimis	 NDA-1	 my child; my fetus	 {ni-} + -(t)awâsimis-
- nicicâskay	 NDI-2	 my crotch, my pubic region	 {ni-} + -cicâskay-
- nicicâskâs	 NDI-1	 my crotch, my pubic region	 {ni-} + -cicâskâs-
- nicihciy	 NDI-2	 my hand; my paw	 {ni-} + -cihciy-
- nicihcîs	 NDI-1	 my finger; my little hand	 {ni-} + -cihcîs-
- nicisk	 NDI-1	 my anus	 {ni-} + -cisk-
- niciskakisiy	 NDI-2	 my rectum (lower end)	 {ni-} + -ciskakisiy-
- niciskêyâpiy	 NDI-2	 my rectum (full length)	 {ni-} + -ciskêyâpiy-
- niciwâm	 NDA-1	 my male parallel cousin; husband of my female cross-cousin; [used by male speaker only] ;; my brother; my friend; my fellow age-mate male ;; [plural:] brethren (in Christian sense) ;; my rival	 {ni-} + -ciwâm-
- niciwâmis	 NDA-1	 my male parallel cousin; husband of my female cross-cousin; [used by male speaker only] ;; my brother; my friend; my fellow age-mate male ;; [plural:] brethren (in Christian sense)	 {ni-} + -ciwâmis-
- niciwâmiskwêm	 NDA-2	 my female parallel cousin; wife of my male cross-cousin; my father's brother's daughter, my mother's sister's daughter ;; my fellow tribeswoman ;; my sister-in-law	 {ni-} + -ciwâmiskwêm-
- nicohcôsimis	 NDA-1	 my nipple	 {ni-} + -cohcôsimis-
- nicâhkos	 NDA-1	 my female cross-cousin; my sister-in-law; [used by a female speaker only]	 {ni-} + -câhkos-
- nicânis	 NDA-1	 my daughter; my parallel niece	 {ni-} + -cânis-
- nicâpân	 NDA-1	 my great-grandparent; my great-grandchild	 {ni-} + -câpân-
- nicâpânis	 NDA-1	 my (very small) great grandchild	 {ni-} + -câpânis-
- nicâsis	 NDA-1	 my small pair of pants, my shorts; my underpants; my loin-cloth; my leggings	 {ni-} + -câsis-
- nicêhis	 NDA-1	 my dear heart [term of endearment]	 {ni-} + -cêhis-
- nicêhis	 NDI-1	 my little heart; [as endearment: NDA-1 "my dear heart"]	 {ni-} + -cêhis-
- nicêmisis	 NDA-1	 my pup, my puppy; my little dog; my little horse	 {ni-} -cêmisis-
- nicêstatay	 NDI-2	 my muscle	 {ni-} + -cêstatay-
- nicêstatayêyâpiy	 NDI-2	 my ligament, my tendon	 {ni-} + -cêstatayêyâpiy-
- nicîhcâwâw	 NDA-2	 my co-parent-in-law	 {ni-} + -cîhcâwâw-
- nicîhcîkom	 NDA-1	 my wart	 {ni-} + -cîhcîkom-
- nicôcêmisis	 NDA-1	 my young friend [said to a child]	 {ni-} + -côcêmisis-
- nicônis	 NDI-1	 my little mouth; [plural:] my lips	 {ni-} + -cônis-
- nicôskwanis	 NDI-1	 my little elbow	 {ni-} + -côskwanis-
- nihcawakâs	 NDI-1	 my little ear	 {ni-} + -htawakâs-
- nihcikwan	 NDI-1	 my knee	 {ni-} + -hcikwan-
- nihcikwanikan	 NDI-1	 my kneebone	 {ni-} + -hcikwanikan-
- nihkwâkan	 NDI-1	 my face	 {ni-} + -hkwâkan-
- nihkwâkanis	 NDI-1	 my little face	 {ni-} + -hkwâkanis-
- nihtawakay	 NDI-2	 my ear	 {ni-} + -htawakay-
- nikayâsim	 NDA-1	 my old flame, my former sweatheart	 {ni-} + -kayâsim-
- nikihci-âniskotâpân	 NDA-1	 my great great great grandparent; my great great great grandchild; my ancestor	 {ni-} + -kihci-âniskotâpân-
- nikisêyinîm	 NDA-1	 my old man, my husband	 {ni-} + -kisêyinîm-
- nikitik	 NDI-3	 my kneecap; my knee	 {ni-} + -kitikw-
- nikocâk	 NDA-1	 my wife's former partner, my wife's ex; [archaic:] my fellow husband	 {ni-} + -kocâk-
- nikocâsiskwêm	 NDA-1	 my husband's former partner, my husband's ex; [archaic:] my fellow wife	 {ni-} + -kocâsiskwêm-
- nikohcaskwayêyâpîsa	 NDI-1	 my bronchial tubes	 {ni-} -kohcaskwayêyâpîs-
- nikohtaskway	 NDI-2	 my throat	 {ni-} -kohtaskway-
- nikohtaskwayêyâpiy	 NDI-2	 my windpipe	 {ni-} + -kohtaskwayêyâpiy-
- nikohtâkan	 NDI-1	 my throat	 {ni-} + -kohtâkan-
- nikosim	 NDA-1	 my nephew; [male speaker:] my brother's son; husband of my sister's daughter; [female speaker:] my sister's son, husband of my brother's daughter	 {ni-} + -kosim-
- nikosis	 NDA-1	 my son; my parallel nephew; [male speaker:] my brother's son; [female speaker:] my sister's son	 {ni-} -kosis-
- nikot	 NDI-1	 my nose	 {ni-} + -kot-
- nikwayaw	 NDI-2	 my neck	 {ni-} + -kwayaw-
- nikwayawikan	 NDI-1	 my neck-bone	 {ni-} + -kwayawikan-
- nikwâskonêw	 NDI-2	 my chin	 {ni-} + -kwâskonêw-
- nikwâskonêwikan	 NDI-1	 my chin	 {ni-} + -kwâskonêwikan-
- nikwêmês	 NDA-1	 my namesake, my friend	 {ni-} + -kwêmês-
- nikâwiy	 NDA-2	 my mother; my mother's sister	 {ni-} + -kâwiy-
- nikâwîs	 NDA-1	 my parallel aunt; my mother's sister, my father's brother's wife; my stepmother; my godmother; "my dear mother"	 {ni-} + -kâwîs-
- nikêhtê-ayim	 NDA-1	 my elder; my parent, my grandparent	 {ni-} + -kêhtê-ayim-
- nimanitôm	 NDA-1	 my god; my Lord	 {ni-} + -manitôm-
- nimanâcimâkan	 NDA-1	 the person with whom I avoid speaking; my in-law of opposite gender; [female speaker:] my father-in-law; [male speaker:] my mother-in-law	 {ni-} + -manâcimâkan-
- niminôsimis	 NDA-1	 my kitten	 {ni-} + -minôsimis-
- nimis	 NDA-1	 my older sister; my older female parallel cousin (i.e. daughter of mother's sister or daughter of father's brother)	 {ni-} + -mis-
- nimiyêsâpiwinân	 NDI-1	 my eyebrow	 {ni-} + -miyêsâpiwinân-
- nimiyêsâpiwinânis	 NDI-1	 my eyelash	 {ni-} + -miyêsâpiwinânis-
- nimosôm	 NDA-1	 my grandfather; [reference extended to all related males of grandfather's generation]; my respected male elder	 {ni-} + -mosôm-
- nimosômipan	 NDA-1	 my deceased grandfather, my late grandfather	 {ni-} + -mosômipan-
- nimâmâ	 NDA-x	 my mom, my mother	 {ni-} + -mâmâ-
- ninahâhkaniskwêm	 NDA-1	 my daughter-in-law	 {ni-} + -nahâhkaniskwêm-
- ninahâhkim	 NDA-1	 my son-in-law	 {ni-} + -nahâhkim-
- ninahâhkisîm	 NDA-1	 my son-in-law	 {ni-} + -nahâhkisîm-
- ninâpêm	 NDA-1	 my husband, my (male) lover	 {ni-} + -nâpêm-
- ninîkihik	 NDA-3	 my parent; my blood relative	 {ni-} + -nîkihikw-
- ninôtokwêm	 NDA-1	 my old lady, my old woman, my wife	 {ni-} + -nôtokwêm-
- nipawâkan	 NDA-1	 my dream spirit	 {ni-} + -pawâkan-
- nipwâm	 NDI-1	 my thigh	 {ni-} + -pwâm-
- nipwâmikan	 NDI-1	 my femur	 {ni-} + -pwâmikan-
- nipâpâ	 NDA-x	 my dad, my father	 {ni-} + -pâpâ-
- nipê-wîci-ispîhcisîmâkan	 NDA-1	 my age-mate from there on down	 {ni-} + -pê-wîci-ispîhcisîmâkan-
- nipêpîm	 NDA-1	 my baby	 {ni-} + -pêpîm-
- nipêyakokosisân	 NDA-1	 my only son	 {ni-} + -pêyakokosisân-
- niscikwânis	 NDI-1	 my head, my little head; my mind	 {ni-} + -scikwânis-
- nisicis	 NDI-1	 my little foot	 {ni-} + -sicis-
- nisikos	 NDA-1	 my aunt, my cross-aunt; my father's sister, my mother's brother's wife; my mother-in-law	 {ni-} -sikos-
- nisis	 NDA-1	 my uncle, my cross-uncle; my mother's brother, my father's sister's husband; my father-in-law	 {ni-} + -sis-
- nisit	 NDI-1	 my foot	 {ni-} + -sit-
- niskan	 NDI-1	 my bone	 {ni-} + -skan-
- niskiwan	 NDI-1	 my nose, my snout	 {ni-} + -skiwan-
- niskiwanikan	 NDI-1	 my nasal bone	 {ni-} + -skiwanikan-
- niskocâkâs	 NDI-2	 my jacket; my short skirt, my mini-skirt	 {ni-} + -skocâkâs-
- niskon	 NDI-1	 my liver	 {ni-} + -skon-
- niskotâkay	 NDI-2	 my coat, my jacket; my dress; my skirt	 {ni-} + -skotâkay-
- niskâhtik	 NDI-3	 my forehead	 {ni-} + -skâhtikw-
- niskâhtikwanikan	 NDI-1	 my frontal bone	 {ni-} + -skâhtikwanikan-
- niskât	 NDI-1	 my leg	 {ni-} + -skât-
- niskâtikan	 NDI-1	 my legbone	 {ni-} + -skâtikan-
- niskîsik	 NDI-3	 my eye	 {ni-} + -skîsikw-
- niskîsikohkâna	 NDI-1	 my eyeglasses, my glasses, my spectacles	 {ni-} + -skîsikohkân-
- niskîsikos	 NDI-1	 my little eye	 {ni-} + -skîsikos-
- niskîsikwâpitân	 NDI-1	 my eye-tooth	 {ni-} + -skîsikwâpitân-
- nispayowak	 NDA-2	 my ovaries	 {ni-} + -spayow-
- nispiconis	 NDI-1	 my little arm	 {ni-} + -spiconis-
- nispikay	 NDI-2	 my side, my ribcage; my rib; [plural:] the sides of my torso	 {ni-} + -spikay-
- nispikêkan	 NDI-1	 my rib, my rib bone	 {ni-} + -spikêkan-
- nispiskwan	 NDI-1	 my back	 {ni-} + -spiskwan-
- nispiton	 NDI-1	 my arm	 {ni-} + -spiton-
- nistikwân	 NDI-1	 my head; my mind	 {ni-} + -stikwân-
- nistikwânaskatihkway	 NDI-2	 top of my skull, my parietal bone	 {ni-} + -stikwânaskatihkway-
- nistikwânikan	 NDI-1	 my skull	 {ni-} + -stikwânikan-
- nistim	 NDA-1	 my niece, my cross-niece; my daughter-in-law; [male speaker:] my sister's daughter; [female speaker:] my brother's daughter	 {ni-} + -stim-
- nistimihkâwin	 NDA-1	 my common-law daughter-in-law	 {ni-} + -stimihkâwin-
- nistês	 NDA-1	 my older brother, my older male parallel cousin (i.e. son of mother's sister or father's brother)	 {ni-} + -stês-
- nisêkipatwân	 NDI-1	 my braid	 {ni-} + -sêkipatwân-
- nisîm	 NDA-1	 my younger sibling (brother or sister)	 {ni-} + -sîm-
- nisîmis	 NDA-1	 my younger sibling (brother or sister)	 {ni-} + -sîmis-
- nisôkan	 NDI-1	 my tail-bone ;; my rear-end, my buttocks	 {ni-} + -sôkan-
- nitakay	 NDI-2	 my penis	 {ni-} + -takay-
- nitakikom	 NDA-1	 my mucus, my snot	 {ni-} + -takikom-
- nitakisiya	 NDI-2	 my intestines, my bowels, my guts, my entrails	 {ni-} + -takisiy-
- nitapiskohkêw	 NDI-2	 back of my skull, my occipital bone	 {ni-} + -tapiskohkêw-
- nitasiskitân	 NDI-1	 calf of my leg; my ligament	 {ni-} + -(t)asiskitân-
- nitaskihkom	 NDA-1	 my pail, my kettle ;; [slang:] my vagina	 {ni-} + -(t)askihkom-
- nitawâsimis	 NDA-1	 my child; my fetus	 {ni-} + -(t)awâsimis-
- nitawêmâw	 NDA-2	 my cross-sibling, my sibling or parallel cousin of opposite gender ;; [male speaker:] my sister; my female parallel cousin (i.e. daughter of my mother's sister or daughter of my father's brother) ;; [female speaker:] my brother; my male parallel cousin (i.e. son of my mother's sister or son of my father's brother)	 {ni-} + -tawêmâw-
- nitayisiyinîm	 NDA-1	 my partner; my follower; [plural:] my people	 {ni-} + -(t)ayisiyinîm-
- nitayân	 NDI-1	 my crotch, my pubic region	 {ni-} + -(t)ayân-
- nitihkom	 NDA-1	 my louse	 {ni-} + -(t)ihkom-
- nitihkwatim	 NDA-1	 my nephew, my cross-nephew (i.e. son of sibling of opposite gender); my son-in-law ;; [male speaker:] my sister's son ;; [female speaker:] my brother's son	 {ni-} + -tihkwatim-
- nitihtihkos	 NDA-1	 my kidney	 {ni-} + -tihtihkos-
- nitihtihkosiw	 NDA-2	 my kidney	 {ni-} + -tihtihkosiw-
- nitihtihkosiy	 NDA-2	 my kidney	 {ni-} + -tihtihkosiy-
- nitihtikon	 NDI-1	 my armpit	 {ni-} + -tihtikon-
- nitihtiman	 NDI-1	 my shoulder	 {ni-} + -tihtiman-
- nitihtimanikan	 NDI-1	 my shoulder-bone	 {ni-} + -tihtimanikan-
- nitihtâwâw	 NDA-1	 my co-parent-in-law	 {ni-} + -tihtâwâw-
- nitisiy	 NDI-2	 my navel, my belly-button	 {ni-} + -tisiy-
- nitisiyêyâpiy	 NDI-2	 my umbilical cord	 {ni-} + -tisiyêyâpiy-
- nitiskwêm	 NDA-1	 my wife, my woman, my (female) lover	 {ni-} + -(t)iskwêm-
- nitisowayak	 NDA-2	 my testicles	 {ni-} + -tisoway-
- nitiy	 NDI-2	 my buttocks	 {ni-} + -tiy-
- nitohtôsim	 NDA-1	 my breast, my nipple	 {ni-} + -tohtôsim-
- nitokan	 NDI-1	 my hip	 {ni-} + -tokan-
- nitâkay	 NDA-2	 my vagina, my vulva	 {ni-} + -tâkay-
- nitânis	 NDA-1	 my daughter ;; [male speaker:] my brother's daughter ;; [female speaker:] my sister's daughter	 {ni-} + -tânis-
- nitâniskocâpân	 NDA-1	 my great-great-grandchild; my great-great-grandparent	 {ni-} + -(t)âniskocâpân-
- nitâniskocâpânis	 NDA-1	 my (very small) great great grandchild	 {ni-} + -(t)âniskocâpânis-
- nitâniskotâpân	 NDA-1	 my great great grandparent; my great great grandchild	 {ni-} + -(t)âniskotâpân-
- nitâpiskan	 NDI-1	 my jaw; my chin	 {ni-} + -tâpiskan-
- nitâpân	 NDA-1	 my great grandparent; my great grandchild	 {ni-} + -tâpân-
- nitâs	 NDA-1	 my pair of pants, trousers	 {ni-} + -tâs-
- nitâs	 NDI-1	 my legging, my gaiter	 {ni-} + -tâs-
- nitâyim	 NDA-1	 my fellow wife	 {ni-} + -tâyim-
- nitêh	 NDI-1	 my heart	 {ni-} + -têh-
- nitêm	 NDA-1	 my dog; my horse	 {ni-} + -têm-
- nitêyaniy	 NDI-2	 my tongue	 {ni-} + -têyaniy-
- nitêyaniyâpiy	 NDI-2	 my tongue string	 {ni-} + -têyaniyâpiy-
- nitêyikom	 NDI-1	 my nostril	 {ni-} + -têyikom-
- nitîhikan	 NDI-1	 my shoulder-blade	 {ni-} + -tîhikan-
- nitîhiy	 NDA-2	 my shoulder-blade	 {ni-} + -tîhiy-
- nitîhkôkan	 NDI-1	 my armpit	 {ni-} + -tîhkôkan-
- nitôkimâm	 NDA-1	 my chief, my leader, my boss; my superior; my king	 {ni-} + (t)ôkimâm-
- nitôkimâskwêm	 NDA-1	 my leader, my boss, my boss-lady; my boss's wife; my chieftess; my superior; my queen	 {ni-} + (t)ôkimâskwêm-
- nitôn	 NDI-1	 my mouth	 {ni-} + -tôn-
- nitôsim	 NDA-1	 my nephew, my parallel nephew ;; [male speaker:] my brother's son; husband of my sister's daughter ;; [female speaker:] my sister's son; husband of my brother's daughter	 {ni-} + -tôsim-
- nitôsimiskwêm	 NDA-1	 my niece, my parallel niece ;; [male speaker:] my brother's daughter, wife of my sister's son ;; [female speaker:] my sister's daughter, wife of my brother's son	 {ni-} + -tôsimiskwêm-
- nitôsis	 NDA-1	 my aunt, my parallel aunt, my mother's sister, my father's brother's wife	 {ni-} + -tôsis-
- nitôsk-âyim	 NDA-1	 my young person, my child, my grandchild	 {ni-} + -(t)ôsk-âyim-
- nitôskinîkiskwêm	 NDA-1	 my young woman; my hired girl	 {ni-} + -(t)ôskinîkiskwêm-
- nitôskwan	 NDI-1	 my elbow	 {ni-} + -tôskwan-
- nitôt	 NDI-x	 my boat, my canoe	 {ni-} + -tôT-
- nitôtêm	 NDA-1	 my friend, my kinsman	 {ni-} + -tôtêm-
- niwiyihkosak	 NDA-1	 my glands	 {ni-} + -wiyihkos-
- niwiyihkwak	 NDA-3	 my glands	 {ni-} + -wiyihkw- + {-ak}
- niwâhkômâkan	 NDA-1	 my relative	 {ni-} + -wâhkômâkan-
- niwîcêwâkan	 NDA-1	 my spouse; my companion, my partner, my buddy, my friend	 {ni-} + -wîcêwâkan-
- niwîcêwâkanis	 NDA-1	 my companion	 {ni-} + -wîcêwâkanis-
- niwîkimâkan	 NDA-1	 my spouse, my wife, my husband; my housemate	 {ni-} + -wîkimâkan-
- niwîtatoskêmâkan	 NDA-1	 my fellow worker, my co-worker	 {ni-} + -wîtatoskêmâkan-
- niyaw	 NDI-1	 my body	 {n-} + -iyaw-
- niyihkos	 NDA-1	 my gland	 {n-} + -iyihkos-
- nâskikan	 NDI-1	 my chest, my breast	 {n-} + -âskikan-
- nâwikan	 NDI-1	 my backbone, my spine; my back	 {n-} + -âwikan-
- nêscakâsa	 NDI-1	 my hair, my short hair	 {n-} + -êscakâs-
- nêstakaya	 NDI-2	 my hair	 {n-} + -êstakay-
- nîcimos	 NDA-1	 my sweetheart, my lover	 {n-} + -îcimos-
- nîpicikan	 NDI-1	 my gums	 {n-} + -îpicikan-
- nîpit	 NDI-1	 my tooth	 {n-} + -îpit-
- nîpitihkâna	 NDI-1	 my false teeth, my dentures	 {n-} + -îpitihkân-
- nîtihp	 NDI-1	 my brain	 {n-} + -îtihp-
- nîtisân	 NDA-1	 my sibling; my brother or sister	 {n-} + -îtisân-
- nôhkom	 NDA-1	 my grandmother; [reference extended to all related females of grandmother's generation]; my respected female elder	 {n-} + -ohkom-
- nôsisim	 NDA-1	 my grandchild; [reference extended to any young person when used by an elder]	 {n-} + -ôsisim-
- ociwâmimâw	 NA-2	 brother, male parallel cousin	 /o-/ + -ciwâm- + /-imâw/
- ocâhkosimâw	 NA-2	 sister-in-law; eldest of all sisters-in-law	 /o-/ + -câhkos- + /-imâw/
- ocêstatay	 NI-2	 gristle; muscle	 {o-} + -cêstatay-
- okakayêsisiw	 NA-2	 cheater	 /o-/ + kakayêsisi- + /-w/
- okakihcimosk	 NA-1	 boaster, braggart	 /o-/ + kakihcimo- + /-sk/
- okakiyâskisk	 NA-1	 liar	 /o-/ + kakiyâski- + /-sk/
- okakiyâskiwâcimon	 NI-1	 tale of falsehoods	 /o-/ + kakiyâski- + [-w-] + âcimon-
- okakêpâtis	 NA-1	 stupid person, fool, nuisance	 /o-/ + kakêpâtisi- - [-i]
- okanawâpokêw	 NA-2	 house-sitter; one who watches the camp	 /o-/ + kanawâpokê- + /-w/
- okanawêwitipiskwêw	 NA-2	 night watchman	 /o-/ + kanawêwitipiskwê- + /-w/
- okanawêyihcikêw	 NA-2	 guard; caretaker; resource officer	 /o-/ + kanawêyihcikê- + /-w/
- okanawêyimatihkowêw	 NA-2	 shepherd	 /o-/ + kanawêyimatihkowê- + /-w/
- okanawêyimostosowêw	 NA-2	 cattle herder	 /o-/ + kanawêyimostosowê- + /-w/
- okanawêyimâwasow	 NA-2	 babysitter	 /o-/ + kanawêyimâwaso- + /-w/
- okanawêyimâyatihkwêw	 NA-2	 shepherd	 /o-/ + kanawêyimâyatihkwê- + /-w/
- okanawêyiskwâhtêmiwêw	 NA-2	 doorkeeper; goaltender, goalkeeper	 /o-/ + kanawêyiskwâhtêmiwê- + /-w/
- okaskikwâcikêw	 NA-2	 seamstress; tailor	 /o-/ + kaskikwâcikê- + /-w/
- okawikîhkâw	 NA-2	 extremely old person	 /o-/ + kawikîhkâ- + /-w/
- okihtimiskiw	 NA-2	 one who is lazy, one who makes no effort to survive	 /o-/ + kihtimiski- + /-w/
- okihtimiw	 NA-2	 lazy person, one who is lazy	 /o-/ + kihtimi- + /-w/
- okimotiskiw	 NA-2	 thief, kleptomaniac	 /o-/ + kimotiski- + /-w/
- okimotiw	 NA-2	 thief	 /o-/ + kimoti- + /-w/
- okinwâpêkikwayaw	 NA-2	 Longneck, personal and family name from Muskeg Lake Cree Nation	 /o-/ + kinwâpêkikwayaw-
- okipahowêsiw	 NA-2	 policeman; prison guard	 /o-/ + kipahowêsi- + /-w/
- okipahowêw	 NA-2	 jailer, prison guard; goalie, goalkeeper, goaltender	 /o-/ + kipahowê- + /-w/
- okiskinohtahiwêw	 NA-2	 leader, guide	 /o-/ + kiskinohtahiwê- + /-w/
- okiskinwahamawâkan	 NA-1	 student, one who is taught	 /o-/ + kiskinwahamawâkan-
- okiskinwahamâkan	 NA-1	 student, scholar; one being taught	 /o-/ + kiskinwahamâkan-
- okiskinwahamâkêw	 NA-2	 teacher, instructor	 /o-/ + kiskinwahamâkê- + /-w/
- okiskiwêhikêw	 NA-2	 prophet ;; traffic controller	 /o-/ + kiskiwêhikê- + /-w/
- okispêwêw	 NA-2	 defender, one who defends and takes part	 /o-/ + kispêwê- + /-w/
- okistikêw	 NA-2	 farmer	 /o-/ + kistikê- + /-w/
- okisêwâtis	 NA-1	 kind person	 /o-/ + kisêwâtisi- - [-i]
- okisêwâtisiw	 NA-2	 kind person	 /o-/ + kisêwâtisi- + /-w/
- okisîpêkihtakinikêw	 NA-2	 floorwasher, janitor	 /o-/ + kisîpêkihtakinikê- + /-w/
- okisîpêkinikêw	 NA-2	 laundry person	 /o-/ + kisîpêkinikê- + /-w/
- okitahamâkêw	 NI-2	 one who forbids	 /o-/ + kitahamâkê- + /-w/
- okitimâkinâkêw	 NA-2	 sympathizer	 /o-/ + kitimâkinâkê- + /-w/
- okitimâkis	 NA-1	 poor person, materially or mentally challenged; [plural:] the poor	 /o-/ + kitimâkisi- - [-i]
- okitimâkisiw	 NA-2	 person in need, one who is poor	 /o-/ + kitimâkisi- + /-w/
- okitohcikêw	 NA-2	 musician; [pl:] orchestra	 /o-/ + kitohcikê- + /-w/
- okiyokêw	 NA-2	 visitor	 /o-/ + kiyokê- + /-w/
- okiyôtêw	 NA-2	 visitor from a great distance	 /o-/ + kiyôtê- + /-w/
- okosisimâw	 NA-2	 son	 /o-/ + -kosis- + /-imâw/
- okoskohiwêw	 NA-2	 startler, one who startles others; name for prairie chicken in âtayôhkâna (legends)	 /o-/ + koskohiwê- + /-w/
- okosâpahcikêw	 NA-2	 foreteller; one who communicates with the spirits	 /o-/ + kosâpahcikê- + /-w/
- okwâskwêpicikanêyâpiy	 NI-2	 angling line, fishing line	 /o-/ + kwâskwêpicikanêyâpiy-
- okwâskwêpicikêw	 NA-2	 angler, fisherman, one who fishes with hook and line	 /o-/ + kwâskwêpicikê- + /-w/
- okâhkâkîcihiwêw	 NA-2	 one who consoles others, a thoughtful person	 /o-/ + kâhkâkîcihiwê- + /-w/
- okâsakêw	 NA-2	 glutton, one who eats a lot	 /o-/ + kâsakê- + /-w/
- okâskipâsowêw	 NA-2	 barber; one who uses a razor	 /o-/ + kâskipâsowê- + /-w/
- okâwîmâw	 NA-2	 mother	 {o-} + -kâwiy- + /-imâw/
- okîhikosimow	 NA-2	 faster, one who fasts	 /o-/ + kîhikosimo- + /-w/
- okîhkwahâhkêw	 NA-2	 wolverine	 /o-/ + kîhkwahâhkêw-
- okîmâpahkêw	 NA-2	 peeping tom; spy	 /o-/ + kîmâpahkê- + /-w/
- okîmôtâpahkêw	 NA-2	 peeping tom; spy	 /o-/ + kîmôtâpahkê- + /-w/
- okînipocikêw	 NA-2	 filer; one who files saws	 /o-/ + kînipocikê- + /-w/
- okîsikow	 NA-2	 angel	 /o-/ + kîsiko- + /-w/
- okîskwêpêsk	 NA-1	 habitual drunkard, alcoholic	 /o-/ + kîskwêpêski- - [-i]
- okîskwêpêw	 NA-2	 drunkard	 /o-/ + kîskwêpê- + /-w/
- okîskwêw	 NA-2	 madman, insane person	 /o-/ + kîskwê- + /-w/
- okîskwêyâtis	 NA-1	 mentally ill person	 /o-/ + kîskwêyâtisi- - [-i]
- omacihtiw	 NA-2	 sinner	 /o-/ + macihti- + /-w/
- omacâtis	 NA-1	 wicked person; nasty, miserable person	 /o-/ + macâtisi- - [i]
- omanaskosîwâkan	 NI-1	 mower (for cutting hay); mowing machine	 /o-/ + manaskosîwâkan-
- omanaskosîwêw	 NA-2	 one who mows; mower	 /o-/ + manaskosîwê- + /-w/
- omanisikêw	 NA-2	 swather, reaper, one who swathes or reaps	 /o-/ + manisikê- + /-w/
- omanitôwiw	 NA-2	 person with supernatural power	 /o-/ + manitôwi- + /-w/
- omasinahikêw	 NA-2	 writer	 /o-/ + masinahikê- + /-w/
- omaskahtwêsk	 NA-1	 purse snatcher; mugger; one who steals another-s partner, wife or husband	 /o-/ + maskahtwêski- - [i]
- omaskisinihkêw	 NA-2	 shoemaker	 /o-/ + maskisinihkê- + /-w/
- omaskosîhkêw	 NA-2	 hay maker	 /o-/ + maskosîhkê- + /-w/
- omawimostamâkêw	 NA-2	 participant in ceremonial rite; petitioner	 /o-/ + mawimostamâkê- + /-w/
- omawisow	 NA-2	 berry-picker	 /o-/ + mawiso- + /-w/
- omihtawêw	 NA-2	 sulker, one who sulks, pouts, expresses regret	 /o-/ + mihtawê- + /-w/
- omikosiskâcihiwêw	 NA-2	 teaser, annoyer; one who teases	 /o-/ + mikosiskâcihiwê- + /-w/
- omisimâw	 NA-2	 eldest sister, oldest sister	 /o-/ + -mis- + /-imâw/
- omosômimâw	 NA-2	 grandfather	 /o-/ + -mosôm- + /-imâw/
- omâcîw	 NA-2	 hunter	 /o-/ + mâcî- + /-w/
- omâham	 NA-3	 voyageur, one who canoes downriver	 /o-/ + mâh- + /-amw/
- omâhamow	 NA-2	 voyageur, boatman, one who goes downriver	 /o-/ + mâhamo- + /-w/
- omâmihkwêw	 NA-2	 Stoney, Assiniboine, Nakota woman	 /o-/ + mâmihkwêw-
- omâwacihcikêw	 NA-2	 collector	 /o-/ + mâwacihcikê- + /-w/
- omâwatinikêw	 NA-2	 collector, one who gathers a collection	 /o-/ + mâwatinikê- + /-w/
- omîcaskosîs	 NA-1	 swallow (bird)	 /o-/ + mîcaskosîs-
- omîhkawikîw	 NA-2	 sprinter, fast runner	 /o-/ + mîhkawikî- + /-w/
- omîkiwahpihkêw	 NA-2	 one who sews tipis, one who makes tipis	 /o-/ + mîkiwahpihkê- + /-w/
- omôhkocikêw	 NA-2	 one who planes	 /o-/ + môhkocikê- + /-w/
- omônisôniyâwêw	 NA-2	 prospector	 /o-/ + mônisôniyâwê- + /-w/
- omôsâhkinikêw	 NA-2	 collector	 /o-/ + môsâhkinikê- + /-w/
- onanâtawihiwêw	 NA-2	 doctor, healer	 /o-/ + nanâtawihiwê- + /-w/
- onaskwahamâkêw	 NA-2	 back-up singer	 /o-/ + naskwahamâkê- + /-w/
- onikamow	 NA-2	 singer	 /o-/ + nikamo- + /-w/
- onikohtêw	 NA-2	 woodcutter	 /o-/ + nikohtê- + /-w/
- onipahiwêw	 NA-2	 murderer	 /o-/ + nipahiwê- + /-w/
- onipahtâkêw	 NA-2	 killer, murderer; executioner	 /o-/ + nipahtâkê- + /-w/
- onipiw	 NA-2	 dead person	 /o-/ + nipi- + /-w/
- onitopayiw	 NA-2	 warrior, person on warpath	 /o-/ + nitopayi- + /-w/
- onâpêhkâsow	 NA-2	 brave man ;; one who pretends to be brave, one who puts up a front	 /o-/ + nâpêhkâso- + /-w/
- onâpêmimâw	 NA-2	 husband	 /o-/ + -nâpêm- + /-imâw/
- onâtamâkêw	 NA-2	 defender (interceding for s.o.); mediator	 /o-/ + nâtamâkê- + /-w/
- onâtawihiwêw	 NA-2	 doctor, healer	 /o-/ + nâtawihiwê- + /-w/
- onîkihikomâw	 NA-2	 parent	 /o-/ + -nîkihikw- + /-imâw/
- onîkâniskât	 NI-1	 front leg	 /o-/ + /nîkân-/ + -skât-
- onîkânohtêw	 NA-2	 leader, one who walks at the head of a group	 /o-/ + nîkânohtê- + /-w/
- onîkânîw	 NA-2	 headman, leader	 /o-/ + nîkânî- + /-w/
- onîmihitow	 NA-2	 dancer	 /o-/ + nîmihito- + /-w/
- onôcihcikêw	 NA-2	 trapper; hunter	 /o-/ + nôcihcikê- + /-w/
- onôcikinosêwêw	 NA-2	 fisherman	 /o-/ + nôcikinosêwê- + /-w/
- onôcikinêpikwêsiw	 NA-2	 snake hawk	 /o-/ + nôcikinêpikwê- + /-isiw/
- onôtinikêsk	 NA-1	 fighter; boxer	 /o-/ + nôtinikêski- - [i]
- onôtinikêskiw	 NA-2	 fighting man	 /o-/ + nôtinikêski- + /-w/
- onôtinikêw	 NA-2	 warrior; [plural:] army	 /o-/ + nôtinikê- + /-w/
- onôtâposwêw	 NA-2	 rabbit hunter	 /o-/ + nôtâposwê- + /-w/
- opahkwêsikanihkêw	 NA-2	 baker	 /o-/ + pahkwêsikanihkê- + /-w/
- opahkêkinohkêw	 NA-2	 tanner, processor of hides	 /o-/ + pahkêkinohkê- + /-w/
- opakatinikêw	 NA-2	 one who plants grain, a garden	 /o-/ + pakatinikê- + /-w/
- opakitahwâw	 NA-2	 fisherman (using nets)	 /o-/ + pakitahwâ- + /-w/
- opakosihtâsk	 NA-1	 beggar	 /o-/ + pakosihtâski- - [i]
- opamihiwêw	 NA-2	 servant; attendant	 /o-/ + pamihiwê- + /-w/
- opaminikêw	 NA-2	 governess; steward; boss, leader; administrator	 /o-/ + paminikê- + /-w/
- opapâmohtêw	 NA-2	 wanderer; prostitute	 /o-/ + papâmohtê- + /-w/
- opapâsîw	 NA-2	 speedy person, person who does things quickly	 /o-/ + papâsî- + /-w/
- opasastêhiwêw	 NA-2	 one who whips others	 /o-/ + pasastêhiwê- + /-w/
- opaskosowêw	 NA-2	 barber	 /o-/ + paskosowê- + /-w/
- opaskostikwânêw	 NA-2	 bald person	 /o-/ + paskostikwânê- + /-w/
- opawahikêw	 NA-2	 thresher, one who threshes grain, one who combines	 /o-/ + pawahikê- + /-w/
- opiminawasow	 NA-2	 chef; cook	 /o-/ + piminawaso- + /-w/
- opimipiciw	 NA-2	 traveller; nomad	 /o-/ + pimipici- + /-w/
- opimohtahiwêw	 NA-2	 bus driver; transporter	 /o-/ + pimohtahiwê- + /-w/
- opimotahkwêw	 NA-2	 archer, one who shoots with bow and arrows	 /o-/ + pimotahkwê- + /-w/
- opimâcihiwêw	 NA-2	 saviour	 /o-/ + pimâcihiwê- + /-w/
- opwâm	 NI-1	 thigh of meat; ham; his/her thigh	 {o-} + -pwâm-
- opwêyakatowêw	 NA-2	 one who peels and gnaws (e.g. a beaver)	 /o-/ + pwêyakatowê- + /-w/
- opwêyakatâmêw	 NI-2	 tree felled by a beaver	 /o-/ + pwêyakatâmê- + /-w/
- opâstâmow	 NA-2	 slanderer; blasphemer; one who brings curses upon him/herself through improper speech or action	 /o-/ + pâstâmo- + /-w/
- opîkopicikêw	 NA-2	 one who ploughs	 /o-/ + pîkopicikê- + /-w/
- opîtatowêw	 NA-2	 Ukrainian; European	 /o-/ + pîtatowê- + /-w/
- opîwayakohp	 NI-1	 feather or down quilt	 /o-/ + pîway- + akohp-
- opôtâcikêw	 NA-2	 trumpeter; flutist	 /o-/ + pôtâcikê- + /-w/
- osaskamow	 NA-2	 one who receives sacrament or communion	 /o-/ + saskamo- + /-w/
- osaskamowin	 NI-1	 sacrament, communion	 /o-/ + saskamo- + /-win/
- oscikwânis	 NA-1	 "little head", "small head"; used as a female personal name	 {o-} + -scikwânis-
- osikosimâw	 NA-2	 mother-in-law; paternal aunt, wife of maternal uncle	 {o-} + -sikos- + /-imâw/
- osisimâw	 NA-2	 father-in-law; maternal uncle, husband of paternal aunt	 /o-/ + -sis- + /-imâw/
- oskan	 NI-1	 bone; his/her bone	 {o-} + -skan-
- ostimimâw	 NA-2	 daughter-in-law; niece	 /o-/ + -stim- + /-imâw/
- ostêsimâw	 NA-2	 oldest brother, eldest brohter, firstborn male	 /o-/ + -stês- + /-imâw/
- osâkohcihiwêw	 NA-2	 victor; one who wins	 /o-/ + sâkohcihiwê- + /-w/
- osâkotêhêw	 NA-2	 coward; timid person	 /o-/ + sâkotêhê- + /-w/
- osêskicês	 NI-1	 roach (traditional men's pow-wow headdress made of porcupine quills)	 {o-} + sêskicês-
- osîkinikêw	 NA-2	 bartender	 /o-/ + sîkinikê- + /-w/
- osîmimâw	 NA-2	 youngest sibling, youngest brother or sister	 /o-/ + -sîm- + /-imâw/
- osîmisimâw	 NA-2	 younger sibling	 /o-/ + -sîmis- + /-imâw/
- otahkonâwasow	 NA-2	 one who carries a child; a nursing mother	 /o-/ + tahkonâwaso- + /-w/
- otahtahkwan	 NDI-1	 his/her wing	 {o-} + -tahtahkwan-
- otapâhtêyimow	 NA-2	 meek, humble person	 /o-/ + tapâhtêyimo- + /-w/
- otasihkêw	 NA-2	 resident	 /o-/ + tasihkê- + /-w/
- otihkwatimimâw	 NA-2	 nephew; son-in-law	 /o-/ + -tihkwatim- + /-imâw/
- otipahaskêw	 NA-2	 surveyor	 /o-/ + tipahaskê- + /-w/
- otipêyihcikêw	 NA-2	 owner; manager; lord	 /o-/ + tipêyihcikê- + /-w/
- otipêyimisow	 NA-2	 independent person; free person	 /o-/ + tipêyimiso- + /-w/
- otâpwêhtam	 NA-3	 believer	 /o-/ + tâpwêht- + {-amw}
- otêhtapiw	 NA-2	 rider, horseman	 /o-/ + têhtapi- + /-w/
- otêpwêstamâkêw	 NA-2	 herald, announcer	 /o-/ + têpwêstamâkê- + /-w/
- otôsimimâw	 NA-2	 nephew; a man's brother's son or woman's sister's son	 /o-/ + -tôsim- + /-imâw/
- otôtêmimâw	 NA-2	 friend	 /o-/ + -tôtêm- + /-imâw/
- owanihikêw	 NA-2	 trapper	 /o-/ + wanihikê- + /-w/
- owaninêw	 NA-2	 crazy person	 /o-/ + waninê- + /-w/
- owiyasiwêw	 NA-2	 judge; lawyer	 /o-/ + wiyasiwê- + /-w/
- owâskahikanihkêw	 NA-2	 house-builder	 /o-/ + wâskahikanihkê- + /-w/
- owâspisonihkêw	 NA-2	 moss-bag maker	 /o-/ + wâspisonihkê- + /-w/
- owîhkohkêw	 NA-2	 one who makes a feast	 /o-/ + wîhkohkê- + /-w/
- owîkihtow	 NA-2	 bridegroom; bride	 /o-/ + wîkihto- + /-w/
- wiyihkosa	 NDA-1	 his/her glands	 {w-} + -iyihkos- {-a}
- wîni	 NDI-4	 bone-marrow; his/her bone-marrow	 {w-} + -în- + {-i}
câpân!	 NDA-1	 Great-Grandparent!; Great-Grandchild!	
kôkom!	 NDA-1	 Grandma!	
môsom!	 NDA-1	 Grandpa!	
niciwâ!	 NDA-1	 brother!; male parallel cousin!; friend!; rival!	 {ni-} + -ciwâ(m)-
nicâhkosê!	 NDA-1	 female cross-cousin!; sister-in-law! [used by female speaker only]	 {ni-} + -câhkos- + {-ê}
nikosê!	 NDA-1	 son!	 {ni-} + /-kos-/ + {-ê}
nikwêmê!	 NDA-1	 namesake! [kinship term: addressing one whom you are named after, one who is named after you, or simply one who shares the same name]	 {ni-} + /-kwêm-/ + {-ê}
nikâ!	 NDA-2	 mother!	 {ni-} + /-kâ/
- nimistikom	 NDI-1	 my cane, my stick ;; [slang:] my penis	 {ni-} + -mistikom-
nimisê!	 NDA-1	 older sister!	 {ni-} + -mis- + {-ê}
nimosô!	 NDA-1	 grandfather!	 {ni-} + /-mosôm-/ - [m]
- nimwâhkohkêw	 NDI-2	 my arm muscle, my biceps	 {ni-} + -mwâhkohkêw-
- ninipîm	 NDI-1	 my amniotic fluid ;; my urine ;; my water, my glass of water, my bottle of water	 {ni-} + -nipîm-
- ninîkânîm	 NDI-1	 my future	 {ni-} + -nîkânim- + /-ihk/
- nipêminak	 NDI-?	 my shin, my calf	 {ni-} + -pêminak(w)-
- nipîhtawâwikanân	 NDI-1	 my spinal chord	 {ni-} + -pîhtawâwikanân-
nisikosê!	 NDA-1	 aunt!, cross-aunt!; father's sister!, mother's brother's wife!; mother-in-law!	 {ni-} + -sikos- + {-ê}
- nisikwâkan	 NDI-1	 the back of my knee	 {ni-} + -sikwâkan-
nisisê!	 NDA-1	 uncle!, cross-uncle!; mother's brother!, father's sister's husband!; father-in-law!	 {ni-} + -sis- + {-ê}
- nisoy	 NDI-2	 my tail	 {ni-} + -soy-
nistêsê!	 NDA-1	 older brother!	 {ni-} + -stês- + {-ê}
- nisêkitikom	 NDI-1	 my tangled hair, my knotted hair, my uncombed hair	 {ni-} + -sêkitikom-
nisîmê!	 NDA-1	 younger sibling!	 {ni-} + -sîm- + {-ê}
- nisôs	 NDI-2	 my little tail	 {ni-} + -sôs-
nitawêmâ!	 NDA-2	 cross-sibling! [male speaker:] sister! female parallel cousin!; [female speaker:] brother! male parallel cousin!	 {ni-} + -tawêmâw- - [-w]
nitihkwâ!	 NDA-1	 nephew!, cross-nephew!; son-in-law!	 {ni-} + -tihkwatim- - [-atim] + {-â}
- nitiyinîmak	 NDA-1	 my people, my followers	 {ni-} + -(t)iyinîm-
- nitostikwânim	 NDI-1	 my severed head (used as lodge emblem)	 {ni-} + -(t)ostikwânim-
nitân!	 NDA-1	 daughter!	 {ni-} + -tânis- - [-is]
- nitôsim	 NDI-1	 my boat, my canoe	 {ni-} + -(t)ôsim-
- nitôskinîkîm	 NDA-1	 my young man; my hired man; my servant; my follower	 {ni-} + -(t)ôskinîkîm-
- nitôskinîkîmis	 NDA-1	 my young man, my hired man	 {ni-} + -(t)ôskinîkîmis-
- niyihkwak	 NDA-3	 my glands	 {n-} + -iyihkw- + {-ak}
nêkâ!	 NDA-2	 mother!	 {ni-} + /-kâ/
- nîc-âyis	 NDA-1	 my fellow youngster, my young age-mate; my sibling; my parallel cousin	 {n-} + -îci-ayis-
- nîci-atoskêyâkan	 NDA-1	 my fellow employee	 {n-} + -îci-atoskêyâkan-
- nîci-ayis	 NDA-1	 my fellow youngster; my sibling; my parallel cousin	 {n-} + -îci-ayis-
- nîci-ayisiyiniw	 NDA-2	 my fellow human, my fellow person	 {n-} + -îci-ayisiyiniw-
- nîci-ayisiyinîm	 NDA-1	 my fellow human	 {n-} + -îci-ayisiyinîm-
- nîci-kiskinwahamawâkan	 NDA-1	 my fellow student, my school-mate	 {n-} + -îci-kiskinwahamawâkan-
- nîci-kisêyin!	 NDA-2	 my fellow old man, my co-elder	 {n-} + -îci-kisêyin-
- nîci-kisêyiniw	 NDA-2	 my fellow old man, my co-elder	 {n-} + -îci-kisêyiniw-
- nîci-kîhkâw	 NDA-2	 my aged spouse; my fellow old person; my fellow oldster; my companion of one's old age	 {n-} + -îci-kîhkâw-
- nîci-nahâhkis	 NDA-1	 my brother-in-law	 {n-} + -îci-nahâhkis-
- nîci-nâpêw	 NDA-2	 my fellow man	 {n-} + -îci-nâpêw-
- nîci-nêhiyaw	 NDA-2	 my fellow Cree, my fellow Indian person; my blood brother	 {n-} + -îci-nêhiyaw-
- nîci-nônimâkan	 NDA-1	 my foster sibling; literally: "my fellow suckling"	 {n-} + -îci-nônimâkan-
- nîcisân	 NDA-1	 my sibling	 {n-} + -îcisân-
- nîcisânis	 NDA-1	 my small sibling, my young sibling, my dear sibling	 {n-} + -îcisânis-
- nîki	 NDI-4	 my home, my dwelling, my house	 {n-} + -îk- + {-i}
- nîkis	 NDI-1	 my small home; my cabin	 {n-} + -îkis-
- nîni	 NDI-4	 my bone-marrow	 {n-} + -în- + {-i}
- nîscâs	 NDA-1	 my male cross-cousin; my father's sister's son, my mother's brother's son; my brother-in-law [used by male speaker only]	 {n-} + -îscâs-
- nîskwa	 NDA-4w	 my husband's former wife, my husband's ex ;; [archaic:] my fellow wife, my co-wife	 {n-} + -îskw- + {-a}
- nîstâw	 NDA-2	 my male cross-cousin; my father's sister's son, my mother's brother's son; my brother-in-law; [used by male speaker only]	 {n-} + -îstâw-
- nîtim	 NDA-3	 my cross-cousin of the opposite gender ;; [male speaker:] daughter of my father's sister or daughter of my mother's brother; my sister-in-law (i.e. wife of male sibling or parellel cousin) ;; [female speaker:] son of my father's sister or son of my mother's brother; my brother-in-law (i.e. husband of female sibling or parellel cousin)	 {n-} + -îtimw-
- nîwa	 NDA-4	 my wife	 {n-} + -îw- + {-a}
- nîwahikan	 NDA-1	 my pounded meat	 {n-} + -îwahikan-
- nîwas	 NDI-x	 my sacred pack, my sacred bundle	 {n-} + -îwaT-
- nôhcâwîs	 NDA-1	 my parallel uncle; my father's brother, my mother's sister's husband; my stepfather; my godfather; my "dear father"	 {n-} + -ohcâwîs-
- nôhkomipan	 NDA-1	 my deceased grandmother, my late grandmother	 {n-} + -ohkomipan-
- nôhkomis	 NDA-1	 my uncle, my parallel uncle; my father's brother, my mother's sister's husband	 {n-} + -ohkomis-
nôhkô!	 NDA-1	 grandmother!	 {n-} + /-ôhkô/
- nôhpan	 NDA-1	 my lung	 {n-} + -ohpan-
nôhtâ!	 NDA-2	 father! ;; [Christian:] Heavenly Father!	 {n-} + /-ohtâ-/
- nôhtâwiy	 NDA-2	 my father ;; [Christian:] Heavenly Father	 {n-} + -ohtâwiy-
- nôhtâwîhkâwin	 NDA-1	 my step-father; my godfather	 {n-} + -ohtâwîhkâwin-
- nôhtâwîpan	 NDA-1	 my deceased father, my late father	 {n-} + -ohtâwîpan-
nôsisê!	 NDA-1	 grandchild!	 {n-} + -ôsis- + {-ê}
- ohpan	 NDI-1	 lung; his/her lung	 {o-} + -hpan-
- osoy	 NDI-2	 tail; its tail	 {o-} + -soy-
- osôs	 NDI-1	 tail; its little tail	 {o-} + -sôs-
- otitâmiyawa	 NDI-2	 his/her innards (e.g. of an animal)	 {o-} + -(t)itâmiyaw-
- otânisimâw	 NA-2	 daughter	 /o-/ + -tânis- + /-imâw/
- wîwa	 NDA-4	 his wife	 {w-} + -îw- + {-a}
